5 10
 # #  # ##
###  # ## 
#   # # ##
 ## #  ###
###   #   